▤▤▤▤▤▤▤▤▤▤▤▤▤▤▤▤▤▤▤▤▤▤▤▤▤▤▤▤▤▤▤▤▤▤▤▤▤▤▤▤▤▤▤▤▤▤▤▤▤▤▤▤▤▤▤▤▤▤▤▤▤▤▤▤▤▤▤▤▤▤▤▤▤▤▤▤▤▤▤▤
▤                            ▤                 ▤   ▤▤     ▤      ▤   ▤   ▤    ▤▤
▤                            ▤                            ▤                    ▤
▤                                                            ▤▤▤▤▤▤▤▤▤▤▤▤▤▤▤▤▤▤▤
▤                            ▤             ♣              ▤                    ▤
▤                            ▤             ♣                                   ▤
▤        ▤▤▤▤▤▤▤▤            ▤                            ▤                    ▤
▤        ▤      ▤            ▤                            ▤                    ▤
▤        ▤      ▤            ▤                            ▤                    ▤
▤        ▤      ▤▤▤▤▤ ▤▤▤▤▤  ▤                            ▤                    ▤
▤   ☺    ▤                   ▤                            ▤                    ▤
▤        ▤                   ▤                            ▤                    ▤
▤        ▤▤▤▤▤▤▤▤▤▤▤▤▤▤▤▤▤▤▤▤▤                            ▤                    ▤
▤                            ▤                            ▤                    ▤
▤                  ♣♣♣       ▤                            ▤                    ▤
▤                   ♣        ▤                            ▤                    ▤
▤  ▤▤▤▤▤▤▤▤ ▤▤▤▤▤▤▤▤▤▤▤▤▤▤   ▤                            ▤                    ▤
▤  ▤                     ▤   ▤                            ▤                    ▤
▤  ▤                         ▤                            ▤                    ▤
▤  ▤                                                      ▤▤▤▤▤▤▤ ▤▤▤▤▤▤▤▤▤▤▤▤ ▤
▤  ▤                     ▤▤▤▤▤                            ▤                    ▤
▤  ▤                         ▤                            ▤                    ▤
▤  ▤                         ▤                            ▤                    ▤
▤  ▤  ▤▤▤▤▤▤▤▤▤ ▤▤▤▤▤▤▤▤▤▤▤▤▤▤            ♣♣♣♣♣♣                               ▤
▤  ▤                         ▤             ♣♣♣♣           ▤                    ▤
▤  ▤                         ▤                            ▤                    ▤
▤  ▤                                                      ▤                    ▤
▤  ▤                         ▤                            ▤                    ▤
▤                            ▤                            ▤                    ▤
▤▤▤▤▤▤▤▤▤▤▤▤▤▤▤▤▤▤▤▤▤▤▤▤▤▤▤▤▤▤▤▤▤▤▤▤▤▤▤▤▤▤▤▤▤▤▤▤▤▤▤▤▤▤▤▤▤▤▤▤▤▤▤▤▤▤▤▤▤▤▤▤▤▤▤▤▤▤▤▤